1 3 1 1 3 1
4 2 0 0 2 4
3 1 3 1 3 1
4 2 4 4 2 4
3 3 1 1 3 3